#####
#@$.#
#####
;
 #######
#      #
#   .  #
#. $@$ #
##  $  #
 #     #
 #    .#
 #######
;